000000000s0|
01111111110|
01000000000|
0101110111f|
01010101000|
01110111000|
00000000000