00000000000|
s1100000000|
00101110000|
0010101001f|
00111010010|
00000011110|
00000000000