00000000000|
s1101110000|
0010101001f|
00101010010|
00111010010|
00000011110|
00000000000